11111111111111111111111111111111
130302050G020P050P020G0502030301
1B0R02000G020P000P020G00020R0B01
1B0R020Y0G020P0W0P020G0Y020R0B01
1B0R020Y0G020P0W0P020G0Y020R0B01
1B0R020Y04020P0W0P02040Y020R0B01
1B0R020Y0G020P0W0P020G0Y020R0B01
1B0R020Y0G020P0W0P020G0Y020R0B01
1B0R02040G020P0W0P020G04020R0B01
1B0R020Y0G020P0W0P020G0Y020R0B01
1B0R020Y0G020P0W0P020G0Y020R0B01
1B0R020Y0G020P0W0P020G0Y020R0B01
10000000000000000000000000000001
10000000000000000000000000000001
10000000000000000000000000000001
10000000000000000000000000000001
10000000000000000000000000000001
10000000000000000000000000000001
10000000000000000000000000000001
10000000000000000000000000000001
10000000000000000000000000000001
10000000000000000000000000000001
10000000000000000000000000000001
10000000000000000000000000000001