11111111111111111111111111111111
10000000000000000000000000000001
10000000000000000000000000000001
1000B0B0B0B0B0B0B0B0B0B0B0B00001
1000Y0Y0Y0Y0Y0Y0Y0Y0Y0Y0Y0Y00001
10000000000000000000000000000001
1000B0B050B0B0B0B0B0B050B0B00001
1000Y0Y000Y0Y0Y0Y0Y0Y000Y0Y00001
10000000000000000000000000000001
1000B0B0B0B0B0B0B0B0B0B0B0B00001
1000Y0Y0Y0Y0Y0Y0Y0Y0Y0Y0Y0Y00001
10000000000000000000000000000001
10000000000000000000000000000001
10000000000000000000000000000001
10000000000000000000000000000001
10000000000000000000000000000001
10000000000000000000000000000001
10000000000000000000000000000001
10000000000000000000000000000001
10000000000000000000000000000001
10000000000000000000000000000001
10000000000000000000000000000001
10000000000000000000000000000001
10000000000000000000000000000001